###############################
#@....#.....#.................#
#..#..#..####..#..#..#######..#
#..#..#........#..#..#..#..#..#
#..#######..#..####..#..#..####
#...........#.....#..#........#
####..####..#######..#..#..#..#
#........#..#..#.....#..#..#..#
#######..####..#..####..#######
#..#........#.................#
#..#..####..####..#..#..####..#
#.....#..#.....#..#..#.....#..#
#..#..#..#..####..#..#..####..#
#..#..#.....#..#..#..#.....#..#
#..##########..#######..#######
#.....#..#.....#.....#........#
#..####..#..#######..####..####
#..#..#.....#........#..#.....#
#..#..#..##########..#..#..#..#
#..............#...........#..#
#############################E#
