###############################
#...@.#.....#........#........#
####..#..#######..#..#..#######
#.....#..#........#...........#
####..#..#..####..####..#######
#..#........#........#........#
#..#..#..#..#..####..#######..#
#.....#..#..#.....#..#........#
##########..####..####..####..#
#..............#..#.....#..#..#
####..#######..##########..####
#.....#..............#..#.....#
##########..#..#..#..#..#..#..#
#...........#..#..#........#..#
#..#..#..####..####..##########
#..#..#.....#.....#...........#
#..#############..#..####..####
#..#........#.....#..#..#.....#
#..####..####..#######..#..####
#..#...........#..............#
#############################E#

