###############################
#@..........#..#..............#
#..####..#..#..#..#..####..####
#.....#..#..#.....#..#........#
##########..#..#..#############
#...........#..#..#........#..#
#..####..#..#..#..####..####..#
#.....#..#.....#...........#..#
#############..#######..####..#
#.................#...........#
#..####..#..################..#
#.....#..#...........#........#
#..#######..#..#######..####..#
#.....#.....#........#.....#..#
#..####..#..#..################
#..#..#..#..#.....#...........#
####..##########..#######..#..#
#..#.....#.....#...........#..#
#..####..#..####..####..#..#..#
#.................#.....#..#..#
############################E##

