###############################
#@....#...........#..#........#
#..#..#..####..####..####..#..#
#..#........#..#...........#..#
####..#######..#..#############
#..#.....#..#.................#
#..####..#..####..#..#..#..####
#.....#..#..#..#..#..#..#.....#
#..#..#..#..#..#..#######..#..#
#..#........#.....#........#..#
################..#############
#.....#..#........#..#........#
####..#..#..#######..#..#..####
#........#..#..#.....#..#.....#
#..#######..#..#..#..#..####..#
#.....#.....#.....#........#..#
#..#..#..#############..#######
#..#.................#........#
#..####..#..##########..#..####
#..#.....#..............#.....#
#############################E#

