###############################
#...@.#...........#...........#
####..#..##########..##########
#..............#.....#..#.....#
#..#######..####..#..#..#..####
#.....#.....#.....#..#........#
#..##########..#..#######..####
#..#..#..#..#..#..#...........#
#..#..#..#..####..##########..#
#........#........#........#..#
#..##########..####..#######..#
#..#........#........#..#..#..#
#..####..##########..#..#..#..#
#..#..#.....#.....#...........#
#..#..#..####..####..##########
#........#..............#.....#
#######..#..#..####..####..#..#
#...........#..#..#..#.....#..#
#..####..####..#..#..#..#..#..#
#.....#..#........#.....#..#..#
############################E##

