##############################
#@...........................#
#.########.###################
#.#......#...................#
#.#.####.#.#################.#
#.#.#....#.#.................#
#.#.#.####.#.###############.#
#.#.#......#.#...............#
#.#.########.#.#############.#
#.#..........#.#.............#
#.############.#.###########.#
#..............#.#...........#
#.##############.#.#########.#
#.#................#.........#
#.#.################.#######.#
#.#......................#...#
#.######################.#.#.#
#......................#.#...#
###########################E##
##############################