########
#...@..#
#......#
#......#
#......#
########